111111111111100001111111111111
100000000010000000010000000001
100111100010011110010001111001
100111100010011110010001111001
100111100010011110010001111001
100000000000000000000000000001
100111111100000000011111111001
100000000001110111000000000001
100100111100010100011100010001
100100000100010100010000010001
100100000100000000010000010001
101111100000010100000011111001
100000000000010100000000000001
111111100001110111000011111111
000000000000000000000000000000
111111100001110111000011111111
100000000000010100000000000001
101011111100010100001111100101
101010000000000000000000100101
101011111100000000001111100101
101000000000000000000000000101
101001011111111111111110100101
101001000000011100000000100101
101001000000011100000000100101
100001000000011100000000100001
101111111110011100111111111101
100000000000000000000000000001
101111111111111111111111111101
100000000000000000000000000001
111111111111100001111111111111