11111111111111000011111111111111
11111111111111000011111111111111
11000000000100000000100000000011
11001111000100111100100011110011
11001111000100111100100011110011
11001111000100111100100011110011
11000000000000000000000000000011
11001111111000000000111111110011
11000000000011101110000000000011
11001001111000101000111000100011
11001000001000101000100000100011
11001000001000000000100000100011
11011111000000101000000111110011
11000000000000101000000000000011
11111111000011101110000111111111
00000000000000000000000000000000
11111111000011101110000111111111
11000000000000101000000000000011
11010111111000101000011111001011
11010100000000000000000001001011
11010111111000000000011111001011
11010000000000000000000000001011
11010010111111111111111101001011
11010010000000111000000001001011
11010010000000111000000001001011
11000010000000111000000001000011
11011111111100111001111111111011
11000000000000000000000000000011
11011111111111111111111111111011
11000000000000000000000000000011
11111111111111000011111111111111
11111111111111000011111111111111